XXXXXXXXXXXXXXXX
1#############XX
XX############XX
XX##XX#XX#XX##XX
XX##XX#XX#XX##XX
XX############XX
XX##XX#XX#XX##XX
XX##XX#XX#XX##XX
XX############XX
XX##XX#XX#XX##XX
XX##XX#XX#XX##XX
XX############XX
XX##XX#XX#XX##XX
XX##XX#XX#XX##XX
XX############XX
XXXXXXXXXXXXX2XX