X11XXXXXXXXXXXXX
X##X###########X
X##X###########X
X##X#####X#####X
X##X#####X#####X
X##X#####X#####X
X##X#####X#X###X
X##X#####X#X###X
X##X##XXXX#X###X
X##X##X####X###X
X##X##X###XX###X
X##X##X###X####X
X#####X###X####X
X#########X####X
XXXXXXXXXXXXX22X