XXXXXXXXXXXX#1XX
XXXXXXXXXXXX##XX
XX############XX
XX############XX
XX##XXXXXXXXXXXX
XX##XXXXXXXXXXXX
XX##XXXXXXXXXXXX
XX############XX
XX############XX
XXXXXXXXXXXX##XX
XXXXXXXXXXXX##XX
XXXXXXXXXXXX##XX
XX############XX
XX############XX
XX##XXXXXXXXXXXX
XX2#XXXXXXXXXXXX