XXXXXXXXXXXXXXXX
X##############1
X###############
X##XXXXXXXXXXXXX
X##XXXXXXXXXXXXX
X##XX##########X
X##XX######XX##X
X##XX######XX##X
X##XX######XX##X
X##########XX##X
X##########XX##X
XXXXXXXXXXXXX##X
XXXXXXXXXXXXX##X
###############X
2##############X
XXXXXXXXXXXXXXXX
